5 5
#####
#@.A#
#.B.#
#A.@#
#####
