5 5
#####
#@.A#
#.A.#
#.a.#
#####
