6 6
######
#@   #
# A  #
#  a #
#    #
######
