5 5
#####
#@  #
#A a#
#   #
#####
